#####
#.G.#
#.S.#
#...#
#####
