#####
#...#
#GS.#
#...#
#####
