#######
#..S..#
#.....#
#G....#
#######