#######
#..S..#
#.....#
#.G...#
#######