#######
#..S..#
#.....#
#..G..#
#######