#######
#G....#
#.....#
#..S..#
#######