#######
#.G...#
#.....#
#..S..#
#######