#######
#..G..#
#.....#
#..S..#
#######