#######
#....G#
#.....#
#..S..#
#######