#######
#....G#
#.....#
#..S..#
#.....#
#.....#
#######
