#######
#.....#
#.....#
#..S..#
#.....#
#G....#
#######
