#####
#...#
#.SG#
#...#
#####
