#######
#....S#
###.###
###.###
#G..###
#######