#####
#...#
#.S.#
#..G#
#####
