#######
#S....#
###.###
###.###
###..G#
#######