#####
#...#
#.S.#
#.G.#
#####
