#########
#######G#
#.......#
#.#KKKK##
#.#KKKK##
#.#KKKK##
#.#KKKK##
#S#KKKK##
#########
#########