##########
#######.G#
##KKKKK.##
##KKKKK.##
##KKKKK.##
##KKKKK.##
#######.##
##S.....##
##########