##########
#DDD#KKKK#
#DDD#KKKK#
#DDD#KKKK#
#GDDD...S#
#DDD#KKKK#
#DDD#KKKK#
#DDD#KKKK#
##########