#####
#...#
#.S.#
#G..#
#####
