########
#G....S#
#..##..#
#.K.D..#
########