########
#S.D..G#
#..#...#
#.K#...#
########