##################
#.K#...#######...#
#......D...#.....#
####...#.#####.#K#
#.S....#.......###
#....###D#####D###
#.....#..K#GD...K#
##################