##################
#...#######...#K.#
#.T.T.#T..D......#
#K#.##### #   ####
###.......#....S.#
###D#####D###..T.#
#K...DG#K..#.....#
##################