##################
#...#######...#K.#
#.....#...D......#
#K#.##### #   ####
###.......#....S.#
###D#####D###....#
#K...DG#K..#.....#
##################