##################
#.K#...#######...#
#......D..T#.T.T.#
####...#.#####.#K#
#.S....#.......###
#.T..###D#####D###
#.....#..K#GD...k#
##################