########
#S....G#
#..##..#
#..D.K.#
########