########
#G..D.S#
#...#..#
#...#K.#
########