#######
#..S..#
#.....#
#...G.#
#######