#####
#G..#
#.S.#
#...#
#####
