#######
#..S..#
#.....#
#....G#
#######