#######
#...G.#
#.....#
#..S..#
#######