#####
#..G#
#.S.#
#...#
#####
