#######
#G....#
#.....#
#..S..#
#.....#
#.....#
#######
