#########
#G#######
#.......#
##KKKK#.#
##KKKK#.#
##KKKK#.#
##KKKK#.#
##KKKK#S#
#########
#########