#########
##KKKK#S#
##KKKK#.#
##KKKK#.#
##KKKK#.#
##KKKK#.#
##KKKK#.#
#.......#
#G#######
#########