##########
#S......##
#######.##
#KKKKKK.##
#KKKKKK.##
#KKKKKK.##
#KKKKKK.##
#######.G#
##########