##########
##.....S##
##.#######
##.KKKKK##
##.KKKKK##
##.KKKKK##
##.KKKKK##
#G.#######
##########