##########
#KKKK#DDD#
#KKKK#DDD#
#KKKK#DDD#
#S...DDDG#
#KKKK#DDD#
#KKKK#DDD#
#KKKK#DDD#
##########