#######
#.....#
#.....#
#..S..#
#.....#
#..G..#
#######
