#######
#.....#
#.....#
#..S..#
#.....#
#....G#
#######
