#######
#.....#
#.....#
#G.S..#
#.....#
#.....#
#######
