#######
#.....#
#.....#
#..S.G#
#.....#
#.....#
#######
