#######
#..G..#
#.....#
#..S..#
#.....#
#.....#
#######
